"filename", "language", "C#", "comment", "blank", "total"
"c:\Users\2020m\Desktop\ZombieRush\Assets\Script\CameraEffects.cs", "C#", 78, 25, 16, 119
"c:\Users\2020m\Desktop\ZombieRush\Assets\Script\CustomCursor.cs", "C#", 11, 1, 2, 14
"c:\Users\2020m\Desktop\ZombieRush\Assets\Script\Enemy\E01\Enemy_01.cs", "C#", -117, -9, -10, -136
"c:\Users\2020m\Desktop\ZombieRush\Assets\Script\Enemy\E0\E0Attack.cs", "C#", 51, 6, 7, 64
"c:\Users\2020m\Desktop\ZombieRush\Assets\Script\Enemy\E0\Enemy0.cs", "C#", 160, 8, 13, 181
"c:\Users\2020m\Desktop\ZombieRush\Assets\Script\Enemy\E1\E1_Attack.cs", "C#", 51, 6, 7, 64
"c:\Users\2020m\Desktop\ZombieRush\Assets\Script\Enemy\E1\Enemy1.cs", "C#", 223, 25, 35, 283
"c:\Users\2020m\Desktop\ZombieRush\Assets\Script\Enemy\EnemyNav.cs", "C#", 58, 16, 17, 91
"c:\Users\2020m\Desktop\ZombieRush\Assets\Script\Globals.cs", "C#", 282, 22, 29, 333
"c:\Users\2020m\Desktop\ZombieRush\Assets\Script\InteractableGrids\InteractableGrids.cs", "C#", 54, 10, 27, 91
"c:\Users\2020m\Desktop\ZombieRush\Assets\Script\Items\BulletBehaviour\Bullet.cs", "C#", -2, 0, 0, -2
"c:\Users\2020m\Desktop\ZombieRush\Assets\Script\Items\BulletShoot\0\BulletBehaviour_0.cs", "C#", -44, 0, -3, -47
"c:\Users\2020m\Desktop\ZombieRush\Assets\Script\Items\BulletShoot\0\DefaultShoot.cs", "C#", -49, -3, -4, -56
"c:\Users\2020m\Desktop\ZombieRush\Assets\Script\Items\BulletShoot\2\Item2.cs", "C#", 108, 15, 10, 133
"c:\Users\2020m\Desktop\ZombieRush\Assets\Script\Items\BulletShoot\Default\BulletBehaviour_0.cs", "C#", 66, 0, 4, 70
"c:\Users\2020m\Desktop\ZombieRush\Assets\Script\Items\BulletShoot\Default\DefaultShoot.cs", "C#", 78, 6, 6, 90
"c:\Users\2020m\Desktop\ZombieRush\Assets\Script\Items\ItemFactory.cs", "C#", 38, -1, 5, 42
"c:\Users\2020m\Desktop\ZombieRush\Assets\Script\Items\ItemInWorld.cs", "C#", 90, 6, 14, 110
"c:\Users\2020m\Desktop\ZombieRush\Assets\Script\Items\Others\BubbleJelly Soda.cs", "C#", 18, 0, 3, 21
"c:\Users\2020m\Desktop\ZombieRush\Assets\Script\Items\Others\FourLeaf.cs", "C#", 18, 1, 2, 21
"c:\Users\2020m\Desktop\ZombieRush\Assets\Script\Items\Others\HighVelocityBullets.cs", "C#", 18, 0, 3, 21
"c:\Users\2020m\Desktop\ZombieRush\Assets\Script\Items\Others\Hyperplasia.cs", "C#", 19, 0, 3, 22
"c:\Users\2020m\Desktop\ZombieRush\Assets\Script\Items\Others\Momentum.cs", "C#", 20, 0, 2, 22
"c:\Users\2020m\Desktop\ZombieRush\Assets\Script\Items\Others\SlimeAcid.cs", "C#", 19, 0, 3, 22
"c:\Users\2020m\Desktop\ZombieRush\Assets\Script\Items\Others\SlimeSupercharge.cs", "C#", 18, 0, 3, 21
"c:\Users\2020m\Desktop\ZombieRush\Assets\Script\Items\Proactive\BladeStorm\BladeStorm.cs", "C#", 60, 13, 11, 84
"c:\Users\2020m\Desktop\ZombieRush\Assets\Script\Items\Proactive\BladeStorm\BladeStormBullet.cs", "C#", 39, 1, 8, 48
"c:\Users\2020m\Desktop\ZombieRush\Assets\Script\Items\Statues.cs", "C#", 18, 0, 2, 20
"c:\Users\2020m\Desktop\ZombieRush\Assets\Script\Loading.cs", "C#", 33, 3, 9, 45
"c:\Users\2020m\Desktop\ZombieRush\Assets\Script\MainMenuCanvas.cs", "C#", 50, 2, 6, 58
"c:\Users\2020m\Desktop\ZombieRush\Assets\Script\Map\ChunkGenerator.cs", "C#", 3, 0, -1, 2
"c:\Users\2020m\Desktop\ZombieRush\Assets\Script\Map\ObjectSpawner.cs", "C#", 22, -4, 4, 22
"c:\Users\2020m\Desktop\ZombieRush\Assets\Script\PlayerResource\PinkResource.cs", "C#", 17, -2, -3, 12
"c:\Users\2020m\Desktop\ZombieRush\Assets\Script\Player\Buildings.cs", "C#", 11, 0, 5, 16
"c:\Users\2020m\Desktop\ZombieRush\Assets\Script\Player\Buildings\B1.cs", "C#", 113, 12, 13, 138
"c:\Users\2020m\Desktop\ZombieRush\Assets\Script\Player\Buildings\B1_Bullet.cs", "C#", 104, 38, 19, 161
"c:\Users\2020m\Desktop\ZombieRush\Assets\Script\Player\PlayerBuildingManager.cs", "C#", 95, 17, 15, 127
"c:\Users\2020m\Desktop\ZombieRush\Assets\Script\Player\PlayerController.cs", "C#", 60, 4, 4, 68
"c:\Users\2020m\Desktop\ZombieRush\Assets\Script\Player\PlayerItemManager.cs", "C#", 74, 5, 5, 84
"c:\Users\2020m\Desktop\ZombieRush\Assets\Script\Player\PlayerObjectManager.cs", "C#", -12, -2, -5, -19
"c:\Users\2020m\Desktop\ZombieRush\Assets\Script\Player\PlayerUI.cs", "C#", -40, -1, -6, -47
"c:\Users\2020m\Desktop\ZombieRush\Assets\Script\Player\UI\BuildingButton.cs", "C#", 64, 9, 8, 81
"c:\Users\2020m\Desktop\ZombieRush\Assets\Script\Player\UI\Descriptions.cs", "C#", 57, 20, 7, 84
"c:\Users\2020m\Desktop\ZombieRush\Assets\Script\Player\UI\HealthBar.cs", "C#", 33, 2, 4, 39
"c:\Users\2020m\Desktop\ZombieRush\Assets\Script\Player\UI\Incoming.cs", "C#", 12, 2, 5, 19
"c:\Users\2020m\Desktop\ZombieRush\Assets\Script\Player\UI\Notices.cs", "C#", 12, 2, 5, 19
"c:\Users\2020m\Desktop\ZombieRush\Assets\Script\Player\UI\PlayerUI.cs", "C#", 206, 13, 22, 241
"c:\Users\2020m\Desktop\ZombieRush\Assets\Script\Player\UI\TimerTextUpdater.cs", "C#", 29, 5, 5, 39
"Total", "-", 2326, 273, 336, 2935